75,198,423,145,670,361,525,556,322,461,195,643,79,812,297,842,600,851
570,160,340,155,193,348,108,492,324,643,514,705,531,862,297,842,91,741
577,830,363,777,206,774,54,631,262,604,467,447,648,286,324,155,144,371
606,663,475,862,338,667,71,665,48,414,166,276,343,183,438,477,648,286
469,168,39,215,252,312,488,432,680,540,568,773,473,669,346,632,234,675,127,770
127,770,400,788,533,872,680,540,478,466,256,579,11,442,168,394,299,300,368,161
675,173,450,229,314,254,261,385,51,448,230,558,454,557,611,616,505,821,301,808,193,842
235,875,233,792,337,791,437,801,664,674,613,596,672,311,632,150,466,261,370,495,234,506,191,346,30,128,56,700
389,163,415,311,257,336,99,389,63,880,171,642,355,853,490,559,596,695
385,177,386,253,492,457,549,511,695,691,645,747,416,865,349,868,58,799,7,744,198,644,262,590,142,336,90,284,175,94
628,813,507,603,386,886,261,653,35,694,10,415,82,146,255,311,377,95,485,290
604,546,418,765,294,786,326,676,7,534,88,499,163,464,243,223,395,408,485,290,673,189
471,774,643,579,631,222,302,95,49,220,217,397,397,554,241,721,70,899
22,133,94,187,174,249,191,601,241,721,290,843,663,630,556,630,458,636,310,451,384,393,460,320
86,162,77,317,229,249,371,223,481,127,520,330,467,491,608,530,500,631,189,597,62,524,66,687,315,844,461,838,388,969
279,105,543,167,228,254,408,400,142,427,352,560,72,631,320,718,107,881,501,933,701,864,637,649,595,509
504,853,461,143,191,829,47,570,627,514,102,243,498,663,204,407,337,600,337,339
343,339,449,240,577,297,689,238,498,663,274,793,137,873,97,1009,544,923,245,549,92,303