399,922,122,779,34,504,230,363,404,482,557,588,725,318
729,463,583,320,379,292,231,422,122,598,251,731,404,841
39,229,720,635,593,824,478,626,356,587,130,595,231,422
293,938,42,625,89,393,289,394,407,620,555,735,720,635
95,315,233,198,417,192,246,545,397,681,563,699,720,635
230,381,359,365,486,332,720,635,502,730,280,938,232,784,60,777
435,739,356,557,205,421,114,593,39,769,483,424,630,264,715,450
244,189,401,381,715,450,629,561,68,552,177,639,287,940,415,910
415,849,503,577,50,516,126,392,286,403,715,450,621,286,471,208
292,650,518,577,724,426,513,244,286,403,53,571,146,841,440,843
730,670,645,718,544,787,511,564,490,338,359,260,286,403,215,582,38,577
730,670,664,533,544,787,503,558,266,729,368,503,113,546,246,320,43,356
37,185,84,546,305,469,444,312,474,576,730,670,547,787,286,838,132,993
492,946,314,766,216,533,49,371,210,212,388,360,497,584,731,478,664,754
49,371,112,291,731,478,607,329,458,199,103,622,314,766,375,598,497,584
107,230,455,177,702,393,557,588,354,493,34,504,227,675,111,844,329,874,632,883
731,556,602,192,372,187,225,380,55,549,331,614,546,737,563,894,329,874,123,773
609,862,395,809,238,806,53,657,294,636,499,479,714,318,662,137,356,187,176,403
732,518,638,695,507,894,370,699,103,697,33,584,80,446,198,308,375,215,470,509,680,318
501,200,51,234,261,337,506,457,712,572,600,805,505,701,378,664,266,707,159,802
159,802,432,820,565,904,712,572,510,498,288,611,43,474,200,426,331,332,400,193
212,141,707,205,482,261,346,286,293,417,83,480,262,590,486,589,643,648,725,736,537,853,333,840,225,874,37,849
267,907,265,824,369,823,469,833,696,706,645,628,704,343,664,182,498,293,402,527,266,538,223,378,62,160,88,732,39,708
421,195,447,343,289,368,131,421,51,331,95,912,203,674,387,885,522,591,628,727,726,626
417,209,418,285,524,489,581,543,727,723,677,779,448,897,381,900,90,831,39,776,230,676,294,622,174,368,122,316,207,126
660,845,730,443,539,635,418,918,293,685,67,726,42,447,114,178,287,343,409,127,517,322
636,578,450,797,326,818,358,708,39,566,120,531,195,496,275,255,427,440,517,322,705,221
503,806,728,764,675,611,663,254,334,127,81,252,249,429,429,586,273,753,102,931,37,595,229,598
54,165,126,219,206,281,223,633,273,753,322,875,695,662,588,662,490,668,342,483,416,425,492,352
79,182,45,332,197,283,403,255,513,159,552,362,565,511718,605,619,499,221,629,94,556,98,719,347,876,493,870,420,1001
454,143,311,137,575,199,260,286,440,432,174,459,384,592,45,576,352,750,539,480,733,896,669,681,627,541
536,885,493,175,223,861,41,600,726,570,134,275,530,695,236,439,369,632,369,371
375,371,481,272,609,329,721,270,530,695,306,825,169,905,129,1041,576,955,277,581,124,335
694,930,550,986,399,922,122,779,34,504,211,557,244,384,284,163,392,315,438,470,557,583,725,318,623,175
80,272,41,484,122,598,251,731,404,841,729,463,583,320,499,175,379,292,231,422,411,543,488,676,561,551
39,229,47,861,176,865,380,953,593,824,720,635,674,507,655,325,482,441,478,626,348,765,356,587,240,534,130,595,231,422
690,144,553,401,433,404,289,394,191,281,89,393,42,625,94,772,293,938,422,858,531,950,555,735,720,635,565,628,407,620
86,869,285,930,720,635,571,683,427,685,292,661,246,545,53,371,137,262,266,177,412,195,499,295,486,416
60,777,192,789,287,870,407,953,502,730,606,705,720,635,466,513,345,638,301,483,122,398,230,381,359,365,486,332,696,292,531,144,285,146,48,138
574,978,524,915,445,922,355,947,269,973,39,769,79,683,114,593,165,508,205,421,285,485,356,557,402,643,435,739,715,450,687,358,630,264,551,343,483,424,385,158,341,235,285,314,212,273,135,235,55,184
244,189,321,288,401,381,500,476,715,450,629,561,564,670,359,503,132,429,68,552,177,639,282,739,168,974,287,940,415,910,526,878
709,1015,563,850,468,716,415,849,224,853,63,872,145,724,50,516,126,392,286,403,494,453,384,592,503,577,710,617,715,450,621,286,471,208,327,164
226,139,424,180,604,183,516,359,286,403,66,299,53,571,292,650,518,577,724,426,696,703,595,913,491,878,377,847,264,820,146,841
455,965,359,954,139,1001,143,877,145,780,38,577,190,579,358,577,511,564,544,787,645,718,730,670,717,445,612,396,490,338,359,260,237,330,150,149
173,144,39,198,43,356,34,473,113,546,114,714,266,711,158,922,378,934,473,953,544,787,503,558,368,503,246,320,449,252,621,310,664,533,730,670
730,670,627,577,474,576,547,787,422,820,286,838,132,993,84,546,178,508,305,469,37,185,145,147,330,236,444,312,583,283,721,134
514,140,365,136,210,212,56,142,49,371,130,456,216,533,285,658,314,766,492,946,664,754,569,671,497,584,458,476,388,360,731,478
112,291,49,371,103,622,124,915,171,993,706,761,603,754,405,823,314,766,384,592,497,584,731,478,646,444,607,329,595,199,458,199
50,868,139,964,288,989,484,989,621,985,729,891,495,858,294,871,298,747,499,739,718,554,721,613,271,391,149,305,136,175,304,52,384,57,632,304,488,422,577,540,504,410,391
729,891,621,985,605,631,517,710,410,798,408,917,294,718,253,1002,151,906,66,799,57,632,433,521,532,473,625,419,721,372,460,158,311,359,260,164,167,183,92,267,52,384
