399,922,122,779,34,504,230,363,404,482,557,588,725,318
729,463,583,320,379,292,231,422,122,598,251,731,404,841
39,229,720,635,593,824,478,626,356,587,130,595,231,422
293,938,42,625,89,393,289,394,407,620,555,735,720,635
95,315,233,198,417,192,246,545,397,681,563,699,720,635
230,381,359,365,486,332,720,635,502,730,280,938,232,784,60,777
435,739,356,557,205,421,114,593,39,769,483,424,630,264,715,450
244,189,401,381,715,450,629,561,68,552,177,639,287,940,415,910
415,849,503,577,50,516,126,392,286,403,715,450,621,286,471,208
292,650,518,577,724,426,513,244,286,403,53,571,146,841,440,843
730,670,645,718,544,787,511,564,490,338,359,260,286,403,215,582,38,577
730,670,664,533,544,787,503,558,266,729,368,503,113,546,246,320,43,356
37,185,84,546,305,469,444,312,474,576,730,670,547,787,286,838,132,993
492,946,314,766,216,533,49,371,210,212,388,360,497,584,731,478,664,754
49,371,112,291,731,478,607,329,458,199,103,622,314,766,375,598,497,584
107,230,455,177,702,393,557,588,354,493,34,504,227,675,111,844,329,874,632,883
731,556,602,192,372,187,225,380,55,549,331,614,546,737,563,894,329,874,123,773
609,862,395,809,238,806,53,657,294,636,499,479,714,318,662,137,356,187,176,403
732,518,638,695,507,894,370,699,103,697,33,584,80,446,198,308,375,215,470,509,680,318
501,200,51,234,261,337,506,457,712,572,600,805,505,701,378,664,266,707,159,802
159,802,432,820,565,904,712,572,510,498,288,611,43,474,200,426,331,332,400,193
212,141,707,205,482,261,346,286,293,417,83,480,262,590,486,589,643,648,725,736,537,853,333,840,225,874,37,849
267,907,265,824,369,823,469,833,696,706,645,628,704,343,664,182,498,293,402,527,266,538,223,378,62,160,88,732,39,708
421,195,447,343,289,368,131,421,51,331,95,912,203,674,387,885,522,591,628,727,726,626
417,209,418,285,524,489,581,543,727,723,677,779,448,897,381,900,90,831,39,776,230,676,294,622,174,368,122,316,207,126
660,845,730,443,539,635,418,918,293,685,67,726,42,447,114,178,287,343,409,127,517,322
636,578,450,797,326,818,358,708,39,566,120,531,195,496,275,255,427,440,517,322,705,221
503,806,728,764,675,611,663,254,334,127,81,252,249,429,429,586,273,753,102,931,37,595,229,598
54,165,126,219,206,281,223,633,273,753,322,875,695,662,588,662,490,668,342,483,416,425,492,352
45,332,79,182,197,283,403,255,513,159,552,299,565,543,718,569,619,677,493,860,420,1001,347,876,98,719,221,629,94,556
454,143,311,137,575,199,260,286,440,432,174,459,384,592,45,576,352,750,539,480,733,896,669,681,627,541
536,885,493,175,223,861,41,600,726,570,134,275,530,695,236,439,369,632,369,371
375,371,481,272,609,329,721,270,530,695,306,825,169,905,129,1041,576,955,277,581,124,335
694,930,550,986,399,922,122,779,34,504,211,557,244,384,284,163,392,315,438,470,557,583,725,318,623,175
80,272,41,484,122,598,251,731,404,841,729,463,583,320,499,175,379,292,231,422,411,543,488,676,561,551
39,229,47,861,176,865,380,953,593,824,720,635,674,507,655,325,482,441,478,626,348,765,356,587,240,534,130,595,231,422
690,144,553,401,433,404,289,394,191,281,89,393,42,625,94,772,293,938,422,858,531,950,555,735,720,635,565,628,407,620
86,869,285,930,720,635,571,683,427,685,292,661,246,545,53,371,137,262,266,177,412,195,499,295,486,416
60,777,192,789,287,870,407,953,502,730,606,705,720,635,466,513,345,638,301,483,122,398,230,381,359,365,486,332,696,292,531,144,285,146,48,138
574,978,524,915,445,922,355,947,269,973,39,769,79,683,114,593,165,508,205,421,285,485,356,557,402,643,435,739,715,450,687,358,630,264,551,343,483,424,385,158,341,235,285,314,212,273,135,235,55,184
244,189,321,288,401,381,500,476,715,450,629,561,564,670,359,503,132,429,68,552,177,639,282,739,168,974,287,940,415,910,526,878
709,1015,563,850,468,716,415,849,224,853,63,872,145,724,50,516,126,392,286,403,494,453,384,592,503,577,710,617,715,450,621,286,471,208,327,164
226,139,424,180,604,183,516,359,286,403,66,299,53,571,292,650,518,577,724,426,696,703,595,913,491,878,377,847,264,820,146,841
455,965,359,954,139,1001,143,877,145,780,38,577,190,579,358,577,511,564,544,787,645,718,730,670,717,445,612,396,490,338,359,260,237,330,150,149
173,144,39,198,43,356,34,473,113,546,114,714,266,711,158,922,378,934,473,953,544,787,503,558,368,503,246,320,449,252,621,310,664,533,730,670
730,670,627,577,474,576,547,787,422,820,286,838,132,993,84,546,178,508,305,469,37,185,145,147,330,236,444,312,583,283,721,134
514,140,365,136,210,212,56,142,49,371,130,456,216,533,285,658,314,766,492,946,664,754,569,671,497,584,458,476,388,360,731,478
112,291,49,371,103,622,124,915,171,993,706,761,603,754,405,823,314,766,384,592,497,584,731,478,646,444,607,329,595,199,458,199
50,868,139,964,288,989,484,989,621,985,729,891,495,858,294,871,298,747,499,739,718,554,721,372,613,271,391,149,305,136,175,304,52,384,57,632,422,577,540,504,418,391,304,488
729,891,621,985,605,631,517,710,410,798,408,917,294,718,253,1002,151,906,66,799,57,632,433,521,532,473,625,419,721,372,460,158,311,359,260,164,167,183,92,267,52,384
476,181,558,292,677,402,715,546,721,716,715,863,509,571,405,676,497,797,378,932,312,791,225,890,99,863,80,756,60,557,242,373,326,269,405,370,327,480
80,176,155,282,265,202,315,332,422,270,455,402,572,396,525,498,207,559,319,622,436,722,556,788,668,733,724,635,668,862,543,913,426,830,313,742,212,679,55,825,131,920,64,1008
208,170,204,296,332,365,496,415,572,501,514,598,737,857,664,954,545,911,461,810,344,777,232,760,299,670,141,682,200,579,32,475,87,365
603,545,575,683,577,806,508,912,404,972,293,963,198,944,142,847,103,726,41,610,346,725,372,615,387,498,265,478,164,403,83,225,193,194,319,187,433,379,506,260,602,185,727,193
608,163,593,241,488,243,354,208,225,233,227,361,124,451,36,492,67,737,194,808,262,927,349,848,415,953,478,832,294,632,361,558,474,590,511,471,633,498,725,413
295,128,158,124,70,176,221,337,215,434,257,515,314,416,366,320,445,271,516,348,592,439,478,576,399,643,482,691,576,683,688,680,582,778,457,800,465,905,243,762,155,810,99,724,36,628,46,527
584,167,415,167,208,152,58,204,60,519,36,642,62,760,215,884,408,870,571,887,521,760,315,762,249,555,364,471,460,558,564,478,631,574,721,473,510,276,300,278
692,781,692,960,545,960,387,963,179,816,48,703,181,700,321,696,455,699,727,508,612,507,480,506,319,503,65,429,70,278,207,279,351,277,614,355
164,596,161,701,166,827,273,836,375,838,386,960,503,960,611,959,718,960,530,703,531,592,533,473,426,463,421,345,304,340,188,344,60,234,186,236,277,149,586,157,691,157,689,250
652,143,726,233,655,318,578,226,316,228,202,159,85,234,199,301,407,478,547,534,408,620,267,551,101,705,41,823,89,945,152,826,354,915,473,867,471,968,596,918,716,915
266,158,45,201,145,334,361,351,573,259,720,245,711,467,561,462,600,657,713,788,707,998,526,1013,396,828,271,697,156,550,44,707,116,840,176,998
63,144,162,371,179,540,314,436,300,314,450,330,576,290,660,157,720,286,554,527,720,677,687,842,463,868,508,692,387,659,284,862,140,907,57,794
518,934,369,918,226,928,301,831,436,829,373,725,58,771,148,685,235,584,121,556,55,155,375,218,261,332,409,377,551,414,671,517,533,570,611,688,695,801
61,301,222,358,338,452,210,533,117,661,41,800,252,839,407,860,608,963,677,821,498,739,347,713,519,561,653,388,706,230,561,148,391,143,523,285
720,1011,643,923,537,683,460,781,388,865,289,950,161,1005,45,967,177,719,211,613,246,513,331,428,440,400,567,395,709,395,427,153,288,166,151,231,57,338
128,964,410,946,662,939,724,793,483,788,323,797,58,812,131,671,408,669,661,665,599,475,314,476,156,484,240,329,515,334,592,186,309,192,154,198
274,643,156,720,267,820,157,919,255,990,616,948,493,888,610,782,486,711,608,624,701,400,683,224,723,137,510,132,282,139,149,189,57,139,78,300,55,468,286,338,290,459,472,439,473,330,371,383
329,129,514,129,704,142,686,329,605,477,715,545,711,760,578,762,680,978,440,960,439,662,319,780,303,976,51,967,51,767,202,584,67,518,59,309,187,301,339,375,451,323
179,1025,42,926,61,776,219,788,368,845,535,995,667,849,708,691,729,412,682,231,561,153,185,144,60,232,200,403,339,275,487,339,554,488,539,653,391,478,236,568
556,161,388,132,214,133,49,206,228,343,135,457,240,509,279,609,273,740,61,940,206,977,361,934,491,985,405,699,528,790,623,677,714,560,600,483
276,135,384,258,220,293,58,319,74,487,310,508,441,467,618,432,694,607,710,760,541,803,393,863,263,952,112,696,320,658,454,619
232,145,96,232,100,399,71,604,188,978,277,855,365,933,468,855,541,976,725,880,525,494,525,638,412,613,266,659,283,506,328,345,472,306,639,154,726,286
153,292,45,384,49,553,148,631,52,696,52,926,286,904,231,817,316,808,368,657,414,769,530,812,471,907,726,913,729,687,645,641,719,383,641,262,405,358,281,454,342,549,429,559,486,462
314,158,170,257,41,354,55,535,102,826,337,908,458,916,673,836,562,544,447,659,408,544,280,595,308,451,474,359,695,271,649,139
61,163,309,659,379,731,471,697,432,586,345,570,347,405,300,321,187,296,138,407,218,462,153,577,156,720,217,841,365,884,492,864,622,750,633,614,581,512,633,395,579,305,463,324,466,428,721,160
80,644,92,784,155,918,308,777,428,982,601,917,524,808,717,706,570,571,679,459,527,376,391,463,253,373,149,425,184,148,393,149,611,155
135,185,359,182,564,180,693,383,478,386,246,389,105,567,362,572,624,563,726,775,513,767,329,766,211,771,163,923,323,921,433,934,715,931
677,201,568,344,639,447,681,625,545,605,440,530,314,519,239,589,347,657,458,676,542,701,669,829,694,965,355,950,132,974,242,810,66,725,87,389,93,178,193,289,310,423
629,994,480,869,325,805,210,947,86,791,89,653,117,404,273,506,445,612,626,747,662,609,534,499,304,354,122,219,318,158,509,269,684,351,624,148
730,243,532,386,550,525,414,589,561,752,685,844,657,990,525,902,344,1000,273,813,103,962,57,706,231,590,296,497,55,403,205,309,66,158
609,185,434,269,260,161,81,158,147,356,329,421,289,684,181,603,148,717,113,823,59,910,411,888,503,774,658,876,714,726,720,527,471,533,590,376
207,151,40,280,86,439,295,491,344,321,462,325,608,181,720,316,676,484,465,497,686,706,715,836,595,785,492,720,432,869,315,736,281,889,37,896,93,727
678,808,537,872,299,991,290,842,385,692,242,641,107,760,44,507,40,152,174,349,266,232,382,205,384,388,575,331,572,526,737,353
264,406,177,375,85,419,51,510,61,605,102,688,185,739,275,702,277,618,199,620,676,393,599,383,522,412,488,488,482,593,511,670,581,728,673,728,722,670,717,592,641,595