107,230,455,177,702,393,557,588,354,493,34,504,227,675,111,844,329,874,632,883
731,556,602,192,372,187,225,380,55,549,331,614,546,737,563,894,329,874,123,773
609,862,395,809,238,806,53,657,294,636,499,479,714,318,662,137,356,187,176,403
732,518,638,695,507,894,370,699,103,697,33,584,80,446,198,308,375,215,470,509,680,318
501,200,51,234,261,337,506,457,712,572,600,805,505,701,378,664,266,707,159,802
159,802,432,820,565,904,712,572,510,498,288,611,43,474,200,426,331,332,400,193
707,205,482,261,346,286,293,417,83,480,262,590,486,589,643,648,537,853,333,840,225,874,37,849
267,907,265,824,369,823,469,833,696,706,645,628,704,343,664,182,498,293,402,527,266,538,223,378,62,160,88,732,39,708
421,195,447,343,289,368,131,421,51,331,95,912,203,674,387,885,522,591,628,727,726,626
417,209,418,285,524,489,581,543,727,723,677,779,448,897,381,900,90,831,39,776,230,676,294,622,174,368,122,316,207,126
660,845,730,443,539,635,418,918,293,685,67,726,42,447,114,178,287,343,409,127,517,322
636,578,450,797,326,818,358,708,39,566,120,531,195,496,275,255,427,440,517,322,705,221
503,806,728,764,675,611,663,254,334,127,81,252,249,429,429,586,273,753,102,931,37,595,229,598
54,165,126,219,206,281,223,633,273,753,322,875,695,662,588,662,490,668,342,483,416,425,492,352
79,182,45,332,197,283,403,255,513,159,552,362,565,511718,605,619,499,221,629,94,556,98,719,347,876,493,870,420,1001
454,143,311,137,575,199,260,286,440,432,174,459,384,592,45,576,352,750,539,480,733,896,669,681,627,541
536,885,493,175,223,861,41,600,726,570,134,275,530,695,236,439,369,632,369,371
375,371,481,272,609,329,721,270,530,695,306,825,169,905,129,1041,576,955,277,581,124,335